franken => bayern
ansbach => ansbach,mittelfranken,franken,bayern
erlangen-höchstadt => erlangen-höchstadt,mittelfranken,franken,bayern
fürth => fürth,mittelfranken,franken,bayern
neustadt a.d.aisch-bad windsheim => neustadt a.d.aisch-bad windsheim,mittelfranken,franken,bayern
nürnberg => nürnberg,mittelfranken,franken,bayern
roth => roth,mittelfranken,franken,bayern
schwabach => schwabach,mittelfranken,franken,bayern
weißenburg-gunzenhausen => weißenburg-gunzenhausen,mittelfranken,franken,bayern
mittelfranken => mittelfranken,franken,bayern
deggendorf => deggendorf,niederbayern,bayern
dingolfing-landau => dingolfing-landau,niederbayern,bayern
freyung-grafenau => freyung-grafenau,niederbayern,bayern
kelheim => kelheim,niederbayern,bayern
landshut => landshut,niederbayern,bayern
passau => passau,niederbayern,bayern
regen => regen,niederbayern,bayern
rottal-inn => rottal-inn,niederbayern,bayern
straubing => straubing,niederbayern,bayern
straubing-bogen => straubing-bogen,niederbayern,bayern
niederbayern => niederbayern,bayern
altötting => altötting,oberbayern,bayern
bad tölz-wolfratshausen => bad tölz-wolfratshausen,oberbayern,bayern
berchtesgadener land => berchtesgadener land,oberbayern,bayern
dachau => dachau,oberbayern,bayern
ebersberg => ebersberg,oberbayern,bayern
eichstätt => eichstätt,oberbayern,bayern
erding => erding,oberbayern,bayern
freising => freising,oberbayern,bayern
fürstenfeldbruck => fürstenfeldbruck,oberbayern,bayern
garmisch-partenkirchen => garmisch-partenkirchen,oberbayern,bayern
ingolstadt => ingolstadt,oberbayern,bayern
landsberg am lech => landsberg am lech,oberbayern,bayern
miesbach => miesbach,oberbayern,bayern
mühldorf am inn => mühldorf am inn,oberbayern,bayern
münchen => münchen,oberbayern,bayern
neuburg-schrobenhausen => neuburg-schrobenhausen,oberbayern,bayern
pfaffenhofen an der ilm => pfaffenhofen an der ilm,oberbayern,bayern
rosenheim => rosenheim,oberbayern,bayern
starnberg => starnberg,oberbayern,bayern
traunstein => traunstein,oberbayern,bayern
weilheim-schongau => weilheim-schongau,oberbayern,bayern
oberbayern => oberbayern,bayern
bamberg => bamberg,oberfranken,franken,bayern
bayreuth => bayreuth,oberfranken,franken,bayern
coburg => coburg,oberfranken,franken,bayern
forchheim => forchheim,oberfranken,franken,bayern
hof => hof,oberfranken,franken,bayern
kronach => kronach,oberfranken,franken,bayern
kulmbach => kulmbach,oberfranken,franken,bayern
lichtenfels => lichtenfels,oberfranken,franken,bayern
wunsiedel im fichtelgebirge => wunsiedel im fichtelgebirge,oberfranken,franken,bayern
oberfranken => oberfranken,franken,bayern
amberg-sulzbach => amberg-sulzbach,oberpfalz,bayern
amberg => amberg,oberpfalz,bayern
cham => cham,oberpfalz,bayern
neumarkt in der oberpfalz => neumarkt in der oberpfalz,oberpfalz,bayern
neustadt an der waldnaab => neustadt an der waldnaab,oberpfalz,bayern
regensburg => regensburg,oberpfalz,bayern
schwandorf => schwandorf,oberpfalz,bayern
tirschenreuth => tirschenreuth,oberpfalz,bayern
weiden in der oberpfalz => weiden in der oberpfalz,oberpfalz,bayern
oberpfalz => oberpfalz,bayern
aichach-friedberg => aichach-friedberg,schwaben,bayern
augsburg => augsburg,schwaben,bayern
dillingen an der donau => dillingen an der donau,schwaben,bayern
donau-ries => donau-ries,schwaben,bayern
günzburg => günzburg,schwaben,bayern
kaufbeuren => kaufbeuren,schwaben,bayern
kempten => kempten,schwaben,bayern
lindau => lindau,schwaben,bayern
memmingen => memmingen,schwaben,bayern
neu-ulm => neu-ulm,schwaben,bayern
oberallgäu => oberallgäu,schwaben,bayern
ostallgäu => ostallgäu,schwaben,bayern
unterallgäu => unterallgäu,schwaben,bayern
schwaben => schwaben,bayern
aschaffenburg => aschaffenburg,unterfranken,franken,bayern
bad kissingen => bad kissingen,unterfranken,franken,bayern
haßberge => haßberge,unterfranken,franken,bayern
kitzingen => kitzingen,unterfranken,franken,bayern
main-spessart => main-spessart,unterfranken,franken,bayern
miltenberg => miltenberg,unterfranken,franken,bayern
rhön-grabfeld => rhön-grabfeld,unterfranken,franken,bayern
schweinfurt => schweinfurt,unterfranken,franken,bayern
würzburg => würzburg,unterfranken,franken,bayern
unterfranken => unterfranken,franken,bayern
pfalz => bayern
zweibrücken => pfalz,bayern
kaiserslautern => pfalz,bayern
kirchheim-bolanden => pfalz,bayern
waldmohr => pfalz,bayern
blieskastel => pfalz,bayern
kusel => pfalz,bayern
landau => pfalz,bayern
bergzabern => pfalz,bayern
langenkandel => pfalz,bayern
speyer => pfalz,bayern
